question	answer
44码和45码的耐克AJ1画报毒上分别多少钱	发售/价格/第三方/尺码
44码耐克AJ1画报什么价了	发售/价格/尺码
44码耐克AJ1画报在毒上倒闭了吗	发售/价格/第三方/尺码
44码耐克AJ1画报在毒上卖多少钱	发售/价格/第三方/尺码
44码耐克AJ1画报在毒上起飞了吗	发售/价格/第三方/尺码
44码耐克AJ1画报多少钱	发售/价格/尺码
44码耐克AJ1画报最低价多少	发售/价格/尺码
44码耐克AJ1画报现在多少可以入手	发售/价格/尺码
44码耐克AJ1画报现在多少钱	发售/价格/尺码
44码耐克AJ1画报能卖多少钱	发售/价格/尺码
44码耐克AJ1画报贵不贵	发售/价格/尺码
APP上耐克AJ1画报吗	发售/渠道/线上
APP明天上耐克AJ1画报吗	发售/时间/线上
clot上发耐克AJ1画报吗	渠道/线上/线上/第三方线上
clot上耐克AJ1画报的抽签开始了吗	发售/时间/线上/第三方线上
clot上面有没有耐克AJ1画报的抽签	渠道/线上/线上/第三方线上
clot什么时候发耐克AJ1画报	发售/时间/线上/第三方线上
clot几点发耐克AJ1画报	发售/时间/线上/第三方线上
clot发不发耐克AJ1画报	渠道/线上/线上/第三方线上
clot哪天发耐克AJ1画报	发售/时间/线上/第三方线上
clot明天发耐克AJ1画报吗	发售/时间/线上/第三方线上
Clot最近会不会上耐克AJ1画报	发售/时间/线上/第三方线上
Nike Beacon什么时候发耐克AJ1画报画 	发售/时间/线下
SNKRS APP美国发耐克AJ1画报吗	发售/渠道/线上/官方线上/官方海外
SNKRS上发不发耐克AJ1画报	发售/渠道/线上/官方线上
SNKRS上啥时候发耐克AJ1画报	发售/时间/线上/官方线上
SNKRS上能不能买到耐克AJ1画报	发售/渠道/线上/官方线上
SNKRS会上耐克AJ1画报吗	发售/渠道/线上/官方线上/官方国内
SNKRS几点发耐克AJ1画报	发售/时间/线上/官方线上
SNKRS发不发耐克AJ1画报	发售/渠道/线上/官方线上
SNKRS发耐克AJ1画报吗	发售/渠道/线上/官方线上
SNKRS啥时候上耐克AJ1画报	发售/时间/线上/官方线上
SNKRS啥时候发耐克AJ1画报	发售/时间/线上/官方线上/官方国内
SNKRS国区会上耐克AJ1画报吗	发售/渠道/线上/官方线上/官方国内
SNKRS国区啥时候上耐克AJ1画报	发售/时间/线上/官方线上/官方国内
SNKRS国区耐克AJ1画报下周什么时候发	发售/时间/线上/官方线上/官方国内
SNKRS明天会上耐克AJ1画报吗	发售/时间/线上/官方线上/官方国内
SNKRS明天几点发耐克AJ1画报	发售/时间/线上/官方线上
SNKRS明天发耐克AJ1画报吗	发售/时间/线上
SNKRS有没有耐克AJ1画报这鞋	发售/渠道/线上/官方线上/官方国内
SNKRS确定什么时候上耐克AJ1画报这鞋了吗	发售/时间/线上/官方线上/官方国内
SNKRS美国会上耐克AJ1画报吗	发售/渠道/线上/官方线上/官方海外
SNKRS美国几点发耐克AJ1画报	发售/时间/线上/官方线上/官方国外
SNKRS美国发耐克AJ1画报吗	发售/渠道/线上/官方线上/官方海外
SNKRS美国哪天发耐克AJ1画报	发售/时间/线上/官方线上/官方国外
SNKRS美国哪天耐克AJ1画报	发售/时间/线上/官方线上/官方国外
SNKRS美国明天会上耐克AJ1画报吗	发售/时间/线上/官方线上/官方国外
SNKRS美国最近会上耐克AJ1画报吗	发售/时间/线上/官方线上/官方国外
SNKRS美国最近发耐克AJ1画报吗	发售/时间/线上/官方线上/官方国外
SNKRS美国这两天会上耐克AJ1画报吗	发售/时间/线上/官方线上/官方国外
SNKRS这段时间会上耐克AJ1画报吗	发售/时间/线上/官方线上/官方国内
上海Nike Beacon过几天发耐克AJ1画报吗	发售/时间/线下/官方线下
上海什么时候发耐克AJ1画报	发售/时间/线下
上海北京DEAL耐克AJ1画报的发售时间出了吗	发售/时间/线下/第三方线下
上海发吗	发售/渠道/线下
上海哪儿能买到耐克AJ1画报	发售/渠道/线下
上海哪几家Nike发耐克AJ1画报	发售/渠道/线下/官方线下
上海念叁上耐克AJ1画报吗	发售/渠道/线下/第三方线下
上海旗舰店几点发耐克AJ1画报	发售/时间/线下/官方线下
上海旗舰店哪天发耐克AJ1画报	发售/时间/线下
上海旗舰店耐克AJ1画报的发售时间出了吗	发售/时间/线下
上海最近有没有耐克AJ1画报卖	发售/时间/线下
上海有店发耐克AJ1画报吗	发售/渠道/线下
上海有没有耐克AJ1画报子卖	发售/渠道/线下
上海的Nike店哪天发耐克AJ1画报	发售/时间/线下/官方线下
上海的店什么时候发耐克AJ1画报	发售/时间/线下
上海的滔博体育什么时候发耐克AJ1画报	发售/时间/线下/官方线下
上海的耐克发不发耐克AJ1画报	发售/渠道/线下/官方线下
上海的耐克店明天发不发耐克AJ1画报	发售/时间/线下/官方线下
上海的耐克店里发不发耐克AJ1画报	发售/渠道/线下/官方线下
上海的耐克这周发不发耐克AJ1画报	发售/时间/线下/官方线下
上海耐克店什么时候发耐克AJ1画报	发售/时间/线下/官方线下
上海耐克旗舰店上不上耐克AJ1画报	发售/渠道/线下/官方线下
上海耐克旗舰店发不发耐克AJ1画报	发售/渠道/线下/官方线下
上海耐克旗舰店发耐克AJ1画报吗	发售/渠道/线下/官方线下
上海能买到耐克AJ1画报吗	发售/渠道/线下
上海西路发耐克AJ1画报吗	发售/渠道/线下
今天耐克AJ1画报在毒上多少钱	发售/价格/第三方
你知不知道耐克AJ1画报发售价多少	发售/价格/官方
你知道哪里能买耐克AJ1画报吗	发售/渠道
你知道国区耐克AJ1画报的消息吗	发售/渠道/线上/官方线上/官方国内
你知道美国官网发什么时候发耐克AJ1画报吗	发售/时间/线上/官方线上/官方国外
你知道美国官网发耐克AJ1画报吗	发售/渠道/线上/官方线上/官方海外
你知道耐克AJ1画报在哪儿买吗	发售/渠道
你知道耐克中国官网发耐克AJ1画报吗	发售/渠道/线上/官方线上/官方国内
到时候耐克AJ1画报在上海北京DEAL发吗	发售/时间/线下/第三方线下
北京DEAL上不上耐克AJ1画报这双鞋	发售/渠道/线下/第三方线下
北京DEAL什么时候发耐克AJ1画报	发售/时间/线下/第三方线下
北京DEAL几点发耐克AJ1画报	发售/时间/线下/第三方线下
北京DEAL发耐克AJ1画报的时间出了没	发售/时间/线下/第三方线下
北京DEAL明天发耐克AJ1画报吗	发售/时间/线下/第三方线下
北京DEAL这周会上不上耐克AJ1画报	发售/时间/线下/第三方线下
北京DEAL这次发耐克AJ1画报吗	发售/渠道/线下/第三方线下
北京发耐克AJ1画报吗	发售/渠道/线下/第三方线下
去上海哪里搞耐克AJ1画报	发售/渠道/线下/官方线下
发耐克AJ1画报的时间是什么时候	发售/时间/线上
发耐克AJ1画报的网站是啥	发售/渠道/线上
听说这次耐克AJ1画报会在别的网上发，啥时候啊	发售/时间/线上/第三方线上
告诉一下发耐克AJ1画报画报的发售时间	发售/时间/线上
告诉一下发耐克AJ1画报的网址	发售/渠道/线上
告诉我耐克AJ1画报发售价多少	发售/价格/官方
告诉我耐克AJ1画报在哪儿买	发售/渠道
哪些城市发耐克AJ1画报	发售/渠道/线下
哪天有耐克AJ1画报卖	发售/时间
哪家电商最近发耐克AJ1画报啊	发售/时间/线上/第三方线上
哪家电商网站发耐克AJ1画报啊	渠道/线上/线上/第三方线上
哪里有耐克AJ1画报卖	发售/渠道
哪里有耐克AJ1画报预售时间	发售/时间/线上/第三方线上
哪里有耐克AJ1画报预售	渠道/线上/线上/第三方线上
国内发耐克AJ1画报吗	发售/渠道
国内官网会上耐克AJ1画报吗	发售/渠道/线上/官方线上/官方国内
国内官网几号发耐克AJ1画报	发售/时间/线上/官方线上/官方国内
国内官网发耐克AJ1画报吗	发售/渠道/线上/官方线上/官方国内
国内官网哪天会上耐克AJ1画报吗	发售/时间/线上/官方线上/官方国内
国内官网最近会上耐克AJ1画报吗	发售/时间/线上/官方线上/官方国内
国内店里什么时候发耐克AJ1画报	发售/时间/线下
国内线下在哪儿能买到耐克AJ1画报	发售/渠道/线下
国区什么时候发耐克AJ1画报啊	发售/时间/线上/官方线上/官方国内
国区会上耐克AJ1画报吗	发售/渠道/线上/官方线上/官方国内
国区会不会发耐克AJ1画报啊	发售/渠道/线上/官方线上/官方国内
国区哪天出耐克AJ1画报	发售/时间/线上/官方线上/官方国内
国区已经上了耐克AJ1画报吗	发售/时间/线上/官方线上/官方国内
国区耐克AJ1画报还没消息吗	发售/时间/线上/官方线上/官方国内
国区这几天耐克AJ1画报吗	发售/时间/线上/官方线上/官方国内
多少钱能在毒上买到耐克AJ1画报	发售/价格/第三方
官网会不会发耐克AJ1画报	发售/渠道/线上/官方线上
官网啥时候卖耐克AJ1画报	发售/时间/线上/官方线上
官网啥时候能买到的到耐克AJ1画报	发售/时间/线上/官方线上
官网能不能买的到耐克AJ1画报	发售/渠道/线上/官方线上
我听说北京DEAL明天要发耐克AJ1画报，真的吗	发售/时间/线下/第三方线下
我听说北京DEAL要发耐克AJ1画报，真的吗	发售/渠道/线下/第三方线下
我听说这次上海不发耐克AJ1画报 真的吗？	发售/渠道/线下
我听说这次上海线下比官网晚好几天发耐克AJ1画报真的吗？	发售/时间/线下
我啥时候能买到耐克AJ1画报	发售/时间
我在哪里能买到耐克	发售/渠道
我在那儿能买耐克AJ1画报	发售/渠道
我想买耐克AJ1画报	发售/渠道
我想知道美国什么时候发耐克AJ1画报	发售/时间/线上/官方线上/官方国外
我想知道美国发不发耐克AJ1画报	发售/渠道/线上/官方线上/官方海外
我朋友说上海要发耐克AJ1画报， 真的假的	发售/渠道/线下
我朋友说上海过几天要发售耐克AJ1画报， 真的假的	发售/时间/线下
旗舰店发耐克AJ1画报吗	发售/渠道/线下
有没有耐克AJ1画报的发售时间	发售/时间/线上
有没有耐克AJ1画报的网址	发售/渠道/线上
朋友说北京DEAL不会发耐克AJ1画报，真的假的	发售/渠道/线下/第三方线下
朋友说北京DEAL明天耐克AJ1画报的发售延期了，真的假的	发售/时间/线下/第三方线下
毒上44码耐克AJ1画报多少钱	发售/价格/第三方/尺码
毒上44码耐克AJ1画报破发了吗	发售/价格/第三方/尺码
毒上44码耐克AJ1画报贵不贵	发售/价格/第三方/尺码
毒上44码耐克AJ1画报飞了吗	发售/价格/第三方/尺码
毒上哪双耐克最便宜	发售/价格/第三方
毒上有耐克AJ1画报的预售吗	渠道/线上/线上/第三方线上
毒上有耐克AJ1画报的预售开始了吗	发售/时间/线上/第三方线上
毒上耐克AJ1画报卖多少钱	发售/价格/第三方
毒上耐克AJ1画报多少钱	发售/价格/第三方
毒上耐克AJ1画报最低价是多少	发售/价格/第三方
毒上耐克AJ1画报预售价多少钱	发售/价格/第三方
海外除了官网，哪些网站发耐克AJ1画报	渠道/线上/线上/第三方线上
海外除了官网，哪些网站明天发耐克AJ1画报	发售/时间/线上/第三方线上
现在毒上有耐克AJ1画报了吗	渠道/线上/线上/第三方线上
现在毒上有耐克AJ1画报预售了吗	发售/时间/线上/第三方线上
现在耐克AJ1画报在毒上啥价格	发售/价格/第三方
线上什么时候发耐克AJ1画报	发售/时间/线上/官方线上
线上什么时候能买耐克AJ1画报	发售/时间/线上
线上怎么买耐克AJ1画报	发售/渠道/线上
网上什么时候发耐克AJ1画报	发售/时间/线上/官方线上
网上什么时候能买到耐克AJ1画报	发售/时间/线上
网上哪儿能买耐克AJ1画报	发售/渠道/线上
网上哪里发耐克AJ1画报	发售/渠道/线上
网上啥时候能买耐克AJ1画报	发售/时间/线上
网上有没有耐克AJ1画报发售时间的消息	发售/时间/线上
网上有没有耐克AJ1画报的消息	发售/渠道/线上
网上的耐克AJ1画报抽签出来了吗	发售/渠道/线上
网上的耐克AJ1画报抽签时间出来了吗	发售/时间/线上
网上能买到耐克AJ1画报吗	发售/渠道/线上
美国哪天上耐克AJ1画报	发售/时间/线上/官方线上/官方国外
美国官网什么时候会上耐克AJ1画报吗	发售/时间/线上/官方线上/官方国外
美国官网会上耐克AJ1画报吗	发售/渠道/线上/官方线上/官方海外
美国官网这几天会发耐克AJ1画报吗	发售/时间/线上/官方线上/官方国外
耐克AJ1画报44码现在多少钱了	发售/价格/尺码
耐克AJ1画报SNKRS发吗	发售/渠道/线上/官方线上
耐克AJ1画报SNKRS怎么说	发售/时间/线上/官方线上/官方国内
耐克AJ1画报上海旗舰店发短信的时间是几点	发售/时间/线下
耐克AJ1画报什么时候SNKRS美国上	发售/时间/线上/官方线上/官方国外
耐克AJ1画报什么时候发售	发售/时间
耐克AJ1画报会不会在clot上	渠道/线上/线上/第三方线上
耐克AJ1画报几号发	发售/时间
耐克AJ1画报几号才能入手	发售/时间
耐克AJ1画报卖多少	发售/价格
耐克AJ1画报卖多少啊	发售/价格/官方
耐克AJ1画报原价多少啊	发售/价格/官方
耐克AJ1画报发不发的	发售/渠道
耐克AJ1画报发售价多少	发售/价格/官方
耐克AJ1画报发售价是多少钱	发售/价格/官方
耐克AJ1画报哪个码在毒上最便宜	发售/价格/第三方/尺码
耐克AJ1画报哪个码在毒上最贵	发售/价格/第三方/尺码
耐克AJ1画报哪天在clot上发	发售/时间/线上/第三方线上
耐克AJ1画报在不在clot发	渠道/线上/线上/第三方线上
耐克AJ1画报在不在国内上	发售/渠道
耐克AJ1画报在哪个网站发	发售/渠道/线上
耐克AJ1画报在哪个网站发的时间出了	发售/时间/线上
耐克AJ1画报在哪儿入手	发售/渠道
耐克AJ1画报在平台上最低价是多少	发售/价格/第三方
耐克AJ1画报在毒上什么价了	发售/价格/第三方
耐克AJ1画报在线上什么时候能买	发售/时间/线上
耐克AJ1画报在线上哪里能买	发售/渠道/线上
耐克AJ1画报多少钱	发售/价格
耐克AJ1画报官方售价多少钱	发售/价格/官方
耐克AJ1画报官网能买到吗	发售/渠道/线上/官方线上
耐克AJ1画报开始预售了吗	发售/时间/线上/第三方线上
耐克AJ1画报是不是要在上海旗舰店发	发售/渠道/线下/官方线下
耐克AJ1画报最近是不是要在上海旗舰店发	发售/时间/线下/官方线下
耐克AJ1画报海外SNKRS怎么说，会发吗？	发售/渠道/线上/官方线上/官方海外
耐克AJ1画报海外SNKRS怎么说，哪天发？	发售/时间/线上/官方线上/官方国外
耐克AJ1画报现在在毒上卖多少钱	发售/价格/第三方
耐克AJ1画报的售价多少	发售/价格
耐克AJ1画报的预售时间有了吗	发售/时间/线上/第三方线上
耐克AJ1画报的预售有了吗	渠道/线上/线上/第三方线上
耐克AJ1画报网上发售有说法了吗	发售/渠道/线上
耐克AJ1画报网上发售的时间有说法了吗	发售/时间/线上
耐克AJ1画报美国什么情况	发售/时间/线上/官方线上/官方国外
耐克AJ1画报美国怎么说	发售/时间/线上/官方线上/官方国外
耐克AJ1画报过几天会不会在上海Jordan发	发售/时间/线下/官方线下
耐克AJ1画报过几天会在北京DEAL 发吗	发售/时间/线下/第三方线下
耐克AJ1画报还要多久才能入手	发售/时间
耐克AJ1画报这个月还发不发	发售/时间
耐克AJ1画报这鞋SNKRS上有吗	发售/渠道/线上/官方线上/官方国内
耐克AJ1画报除了官网，网上还有哪儿能买到	渠道/线上/线上/第三方线上
耐克AJ画报怎么入手	发售/渠道
耐克clot啥时候上耐克AJ1画报	发售/时间/线上/官方线上/官方国内
耐克上海旗舰店上海什么时候上耐克AJ1画报	发售/时间/线下/官方线下
耐克官网上耐克AJ1画报了吗	发售/渠道/线上/官方线上
耐克官网发耐克AJ1画报吗	发售/渠道/线上/官方线上
这个月有没有耐克AJ1画报	发售/时间
这次耐克AJ1画报哪一天在上海八一路耐克店发	发售/时间/线下/官方线下
这次耐克AJ1画报哪天在上海发	发售/时间/线下
这次耐克AJ1画报在上海Nike Beacon发吗	发售/渠道/线下/官方线下
这次耐克AJ1画报在上海北京DEAL发吗	发售/渠道/线下/第三方线下
这次耐克AJ1画报在上海发吗	发售/渠道/线下
这次耐克AJ1画报在上海的耐克店发吗	发售/渠道/线下/官方线下
这次耐克AJ1画报在北京DEAL发吗	发售/渠道/线下/第三方线下
